.............................................................................................................................................
.............................................................................................................................................
.............................................................................................................................................
.............................................................................................................................................
.............................................................................................................................................
.............................................................................................................................................
.............................................................................................................................................
.............................................................................................................................................
.............................................................................................................................................
.............................................................................................................................................
.............................................................................................................................................
.............................................................................................................................................
.............................................................................................................................................
.............................................................................................................................................
.............................................................................................................................................
.............................................................................................................................................
.........................................................................................................................................F...
22222222222222..........222222222222222222222222222222222222222222222222222222222222222.......22222222222222222222222222222222222222222222222
11111111111111..........111111111111111111111111111111111111111111111111111111111111111.......11111111111111111111111111111111111111111111111